family	host	host.name
Phycodnaviridae	Algae	Algae DNA Viruses
Pithoviridae	Eukaryotes	Amoeba DNA Viruses
Adenoviridae	Animals	Animal DNA Viruses
Anelloviridae	Animals	Animal DNA Viruses
Herpesviridae	Animals	Animal DNA Viruses
Parvoviridae	Animals	Animal DNA Viruses
Polyomaviridae	Animals	Animal DNA Viruses
Circoviridae	Animals	Animal DNA Viruses
Alloherpesviridae	Animals	Animal DNA Viruses
Papillomaviridae	Animals	Animal DNA Viruses
Poxviridae	Animals	Animal DNA Viruses
Astroviridae	Animals	Animal RNA Viruses
Caliciviridae	Animals	Animal RNA Viruses
Picornaviridae	Animals	Animal RNA Viruses
Peribunyaviridae	Animals	Animal RNA Viruses
Picobirnaviridae	Animals	Animal RNA Viruses
Retroviridae	Animals	Animal RNA Viruses
Flaviviridae	Animals	Animal RNA Viruses
Pneumoviridae	Animals	Animal RNA Viruses
Aeropyrum	Archaea	Archaeal Viruses
Ampullaviridae	Archaea	Archaeal Viruses
Bicaudaviridae	Archaea	Archaeal DNA Viruses
Fuselloviridae	Archaea	Archaeal Viruses
Globuloviridae	Archaea	Archaeal Viruses
Guttaviridae	Archaea	Archaeal Viruses
Halovirus	Archaea	Archaeal Viruses
Hyperthermophilic	Archaea	Archaeal Viruses
Lipothrixviridae	Archaea	Archaeal Viruses
Pyrobaculum	Archaea	Archaeal Viruses
Pyrococcus	Archaea	Archaeal Viruses
Rudiviridae	Archaea	Archaeal Viruses
Salterprovirus	Archaea	Archaeal Viruses
Sulfolobales	Archaea	Archaeal Viruses
Sulfolobus	Archaea	Archaeal Viruses
Thermococcus	Archaea	Archaeal Viruses
Turriviridae	Archaea	Archaeal Viruses
Ackermannviridae	Bacteria	Bacteriophages
Inoviridae	Bacteria	Bacteriophages
Microviridae	Bacteria	Bacteriophages
Myoviridae	Bacteria	Bacteriophages
Podoviridae	Bacteria	Bacteriophages
Siphoviridae	Bacteria	Bacteriophages
Sphaerolipoviridae	Bacteria	Bacteriophages
Aurantimonas	Bacteria	Bacteriophages
Bacillus	Bacteria	Bacteriophages
Brucella	Bacteria	Bacteriophages
Celeribacter	Bacteria	Bacteriophages
Cellulophaga	Bacteria	Bacteriophages
Clostridium	Bacteria	Bacteriophages
Corticoviridae	Bacteria	Bacteriophages
Cyanophage	Bacteria	Bacteriophages
Deep-sea	Bacteria	Bacteriophages
Enterobacteria	Bacteria	Bacteriophages
Enterococcus	Bacteria	Bacteriophages
Erwinia	Bacteria	Bacteriophages
Flavobacterium	Bacteria	Bacteriophages
Geobacillus	Bacteria	Bacteriophages
Halorubrum	Bacteria	Bacteriophages
Hydrogenobaculum	Bacteria	Bacteriophages
Idiomarinaceae	Bacteria	Bacteriophages
Lactobacillus	Bacteria	Bacteriophages
Loktanella	Bacteria	Bacteriophages
Marinomonas	Bacteria	Bacteriophages
Mycoplasma	Bacteria	Bacteriophages
Nitrincola	Bacteria	Bacteriophages
Oenococcus	Bacteria	Bacteriophages
Paenibacillus	Bacteria	Bacteriophages
Phormidium	Bacteria	Bacteriophages
Plasmaviridae	Bacteria	Bacteriophages
Pleolipoviridae	Bacteria	Bacteriophages
Prochlorococcus	Bacteria	Bacteriophages
Propionibacterium	Bacteria	Bacteriophages
Providencia	Bacteria	Bacteriophages
Pseudoalteromonas	Bacteria	Bacteriophages
Pseudomonas	Bacteria	Bacteriophages
Ralstonia	Bacteria	Bacteriophages
Rhizobium	Bacteria	Bacteriophages
Rhodobacter	Bacteria	Bacteriophages
Rhodococcus	Bacteria	Bacteriophages
Salicola	Bacteria	Bacteriophages
Salisaeta	Bacteria	Bacteriophages
Salmonella	Bacteria	Bacteriophages
Sinorhizobium	Bacteria	Bacteriophages
Sodalis	Bacteria	Bacteriophages
Staphylococcus	Bacteria	Bacteriophages
Streptococcus	Bacteria	Bacteriophages
Sulfitobacter	Bacteria	Bacteriophages
Synechococcus	Bacteria	Bacteriophages
Tectiviridae	Bacteria	Bacteriophages
Tetraselmis	Bacteria	Bacteriophages
Tetrasphaera	Bacteria	Bacteriophages
Thermus	Bacteria	Bacteriophages
uncultured	Bacteria	Bacteriophages
Vibrio	Bacteria	Bacteriophages
Xanthomonas	Bacteria	Bacteriophages
crAssphage	Bacteria	Bacteriophages
Herelleviridae	Bacteria	Bacteriophages
Abalone	Animals	Eukaryotic Viruses
Acheta	Animals	Eukaryotic Viruses
Acyrthosiphon	Animals	Eukaryotic Viruses
Adelphocoris	Animals	Eukaryotic Viruses
Aedes	Eukaryotes	Eukaryotic Viruses
Ageratum	Plants	Eukaryotic Viruses
Alfalfa	Plants	Eukaryotic Viruses
Alphaflexiviridae	Fungi&Plants	Eukaryotic Viruses
Alphatetraviridae	Animals	Eukaryotic Viruses
Alternaria	Fungi	Eukaryotic Viruses
Alvernaviridae	Algae	Eukaryotic Viruses
Amalgaviridae	Animals	Eukaryotic Viruses
Ancient	Environment	Eukaryotic Viruses
Anopheline-associated	Animals	Eukaryotic Viruses
Anphevirus	Animals	Eukaryotic Viruses
Antarctic	Environment	Eukaryotic Viruses
Aphis	Animals	Eukaryotic Viruses
Apis	Animals	Eukaryotic Viruses
Arabis	Plants	Eukaryotic Viruses
Arenaviridae	Animals	Eukaryotic Viruses
Arhar	Plants	Eukaryotic Viruses
Arlivirus	Animals	Eukaryotic Viruses
Arteriviridae	Animals	Eukaryotic Viruses
Aspergillus	Fungi	Eukaryotic Viruses
Aumaivirus	Plants	Eukaryotic Viruses
Bacilladnavirus	Algae	Eukaryotic Viruses
Bacillarnavirus	Algae	Eukaryotic Viruses
Bamboo	Plants	Eukaryotic Viruses
Barnaviridae	Fungi	Eukaryotic Viruses
Beet	Plants	Eukaryotic Viruses
Begomovirus-associated	Plants	Eukaryotic Viruses
Beihai	Animals	Eukaryotic Viruses
Benyviridae	Plants	Eukaryotic Viruses
Bhendi	Plants	Eukaryotic Viruses
Bhindi	Plants	Eukaryotic Viruses
Bidnaviridae	Animals	Eukaryotic Viruses
Big	Animals	Eukaryotic Viruses
Biomphalaria	Animals	Eukaryotic Viruses
Biratnagar	Animals	Eukaryotic Viruses
Birnaviridae	Animals	Eukaryotic Viruses
Bivalve	Animals	Eukaryotic Viruses
Blackcurrant	Plants	Eukaryotic Viruses
Blueberry	Plants	Eukaryotic Viruses
Boiling	Environment	Eukaryotic Viruses
Bole	Animals	Eukaryotic Viruses
Bombyx	Animals	Eukaryotic Viruses
Bornaviridae	Animals	Eukaryotic Viruses
Botrytis	Fungi	Eukaryotic Viruses
Botybirnavirus	Fungi	Eukaryotic Viruses
Bovine	Animals	Eukaryotic Viruses
Bradson	Animals	Eukaryotic Viruses
Bromoviridae	Plants	Eukaryotic Viruses
Bromus-associated	Plants	Eukaryotic Viruses
Burke-Gilman	Animals	Eukaryotic Viruses
Canine	Animals	Eukaryotic Viruses
Cardamom	Plants	Eukaryotic Viruses
Carmotetraviridae	Animals	Eukaryotic Viruses
Carrot	Plants	Eukaryotic Viruses
Cassava	Plants	Eukaryotic Viruses
Caulimoviridae	Plants	Eukaryotic Viruses
Cedratvirus	Protozoa	Eukaryotic Viruses
Cereal	Plants	Eukaryotic Viruses
Chaetoceros	Algae	Eukaryotic Viruses
Chamois	Animals	Eukaryotic Viruses
Changjiang	Animals	Eukaryotic Viruses
Changping	Animals	Eukaryotic Viruses
Chicken	Animals	Eukaryotic Viruses
Chicory	Plants	Eukaryotic Viruses
Chilli	Plants	Eukaryotic Viruses
CHIV14	Environment	Eukaryotic Viruses
Chronic	Animals	Eukaryotic Viruses
Cilevirus	Plants	Eukaryotic Viruses
Circo-like	Environment	Eukaryotic Viruses
Circovirus-like	Environment	Eukaryotic Viruses
Circulifer	Animals	Eukaryotic Viruses
Cladosporium	Fungi	Eukaryotic Viruses
Cleome	Plants	Eukaryotic Viruses
Coconut	Plants	Eukaryotic Viruses
Colletotrichum	Fungi	Eukaryotic Viruses
Cordoba	Animals	Eukaryotic Viruses
Corey	Animals	Eukaryotic Viruses
Coronaviridae	Animals	Animal RNA Viruses
Cotton	Plants	Eukaryotic Viruses
Croton	Plants	Eukaryotic Viruses
Crustavirus	Animals	Eukaryotic Viruses
Cryphonectria	Fungi	Eukaryotic Viruses
Ctenophore-associated	Animals	Eukaryotic Viruses
Cuban	Plants	Eukaryotic Viruses
Cucumber	Plants	Eukaryotic Viruses
Cucurbit	Plants	Eukaryotic Viruses
Culex	Eukaryotes	Eukaryotic Viruses
Curvularia	Fungi	Eukaryotic Viruses
Cyanoramphus	Environment	Eukaryotic Viruses
Cymbidium	Plants	Eukaryotic Viruses
Daeseongdong	Animals	Eukaryotic Viruses
Deer	Animals	Eukaryotic Viruses
Delisea	Algae	Eukaryotic Viruses
Deltavirus	Animals	Eukaryotic Viruses
Diabrotica	Animals	Eukaryotic Viruses
Diaphorina	Animals	Eukaryotic Viruses
Diaporthe	Fungi	Eukaryotic Viruses
Dicistroviridae	Animals	Eukaryotic Viruses
Diplodia	Fungi	Eukaryotic Viruses
Dragonfly	Animals	Eukaryotic Viruses
Drosophila	Animals	Eukaryotic Viruses
Duck	Animals	Eukaryotic Viruses
Dunaliella	Algae	Eukaryotic Viruses
Duwamo	Environment	Eukaryotic Viruses
Egaro	Environment	Eukaryotic Viruses
Endornaviridae	Fungi&Plants	Eukaryotic Viruses
Ethiopian	Plants	Eukaryotic Viruses
Euphorbia	Plants	Eukaryotic Viruses
Faba	Plants	Eukaryotic Viruses
Filoviridae	Animals	Eukaryotic Viruses
Fimoviridae	Plants	Eukaryotic Viruses
Fisavirus	Animals	Eukaryotic Viruses
flavivirus	Flaviviridae	Eukaryotic Viruses
Fort	Animals	Eukaryotic Viruses
Fusarium	Fungi&Plants	Eukaryotic Viruses
Fusariviridae	Fungi	Eukaryotic Viruses
Gamboa	Animals	Eukaryotic Viruses
Gammaflexiviridae	Fungi	Eukaryotic Viruses
Gastropod	Animals	Eukaryotic Viruses
Geminiviridae	Plants	Eukaryotic Viruses
gemycircularvirus	Genomoviridae	Eukaryotic Viruses
Genomoviridae	Animals	Eukaryotic Viruses
Gentian	Plants	Eukaryotic Viruses
Gorilla	Animals	Eukaryotic Viruses
Gossypium	Plants	Eukaryotic Viruses
Goutanap	Animals	Eukaryotic Viruses
Grapevine	Plants	Eukaryotic Viruses
Groundnut	Plants	Eukaryotic Viruses
Guar	Plants	Eukaryotic Viruses
Halastavi	Animals	Eukaryotic Viruses
Hantaviridae	Animals	Eukaryotic Viruses
Hepadnaviridae	Animals	Eukaryotic Viruses
Hepeviridae	Animals	Eukaryotic Viruses
Hibiscus	Plants	Eukaryotic Viruses
Higrevirus	Plants	Eukaryotic Viruses
Hollyhock	Plants	Eukaryotic Viruses
Hubei	Animals	Eukaryotic Viruses
Human	Animals	Eukaryotic Viruses
Husa-like	Animals	Eukaryotic Viruses
Hypoviridae	Fungi	Eukaryotic Viruses
Hytrosaviridae	Animals	Eukaryotic Viruses
Idaeovirus	Plants	Eukaryotic Viruses
Iflaviridae	Animals	Eukaryotic Viruses
Imjin	Animals	Eukaryotic Viruses
Iridoviridae	Invertebrate	Invertebrate DNA Viruses
Jingmen	Animals	Eukaryotic Viruses
Kaumoebavirus	Protozoa	Eukaryotic Viruses
Kelp	Animals	Eukaryotic Viruses
Kilifi	Animals	Eukaryotic Viruses
Labyrnavirus	Algae	Eukaryotic Viruses
Lake	Environment	Eukaryotic Viruses
Lavidaviridae	Protozoa	Eukaryotic Viruses
Lemur	Animals	Eukaryotic Viruses
Leptopilina	Animals	Eukaryotic Viruses
Leshenault	Eukaryotes	Eukaryotic Viruses
Livupivirus	Animals	Eukaryotic Viruses
Llama	Animals	Eukaryotic Viruses
Lodeiro	Animals	Eukaryotic Viruses
Lonestar	Animals	Eukaryotic Viruses
Lucerne	Plants	Eukaryotic Viruses
Luteoviridae	Plants	Eukaryotic Viruses
Magnaporthe	Fungi	Eukaryotic Viruses
Malacoherpesviridae	Animals	Eukaryotic Viruses
Malvastrum	Plants	Eukaryotic Viruses
Marine	Environment	Eukaryotic Viruses
Marnaviridae	Algae	Eukaryotic Viruses
Marseilleviridae	Animals&Protozoa	Eukaryotic Viruses
McMurdo	Algae	Eukaryotic Viruses
Megabirnaviridae	Fungi	Eukaryotic Viruses
Melon	Plants	Eukaryotic Viruses
Mesoniviridae	Animals	Eukaryotic Viruses
Mesta	Plants	Eukaryotic Viruses
Micromonas	Algae	Eukaryotic Viruses
Milk	Plants	Eukaryotic Viruses
Mimosa	Plants	Eukaryotic Viruses
Mollivirus	Protozoa	Eukaryotic Viruses
Mymonaviridae	Fungi	Eukaryotic Viruses
Nairoviridae	Animals	Eukaryotic Viruses
Nanoviridae	Plants	Eukaryotic Viruses
narna-like	Animals	Eukaryotic Viruses
Narnaviridae	Fungi&Protozoa	Eukaryotic Viruses
Negevirus	Animals	Eukaryotic Viruses
Nepavirus	Environment	Eukaryotic Viruses
Nesidiocoris	Animals	Eukaryotic Viruses
New	Plants	Eukaryotic Viruses
Nimaviridae	Animals	Eukaryotic Viruses
Nodaviridae	Animals	Eukaryotic Viruses
Nora	Animals	Eukaryotic Viruses
Nudiviridae	Animals	Eukaryotic Viruses
Nyamiviridae	Animals	Eukaryotic Viruses
Nylanderia	Animals	Eukaryotic Viruses
Okra	Plants	Eukaryotic Viruses
Olive	Plants	Eukaryotic Viruses
Ophioviridae	Plants	Eukaryotic Viruses
Orthomyxoviridae	Animals	Eukaryotic Viruses
Ostreococcus	Algae	Eukaryotic Viruses
Ourmiavirus	Plants	Eukaryotic Viruses
Oyster	Fungi	Eukaryotic Viruses
Pacmanvirus	Protozoa	Eukaryotic Viruses
Pandoravirus	Protozoa	Eukaryotic Viruses
Papanivirus	Plants	Eukaryotic Viruses
Papaya	Plants	Eukaryotic Viruses
Paramyxoviridae	Animals	Eukaryotic Viruses
Parthenium	Plants	Eukaryotic Viruses
Partitiviridae	Fungi&Plants	Eukaryotic Viruses
Pea	Plants	Eukaryotic Viruses
Peanut	Plants	Eukaryotic Viruses
Pedilanthus	Plants	Eukaryotic Viruses
Penicillium	Fungi	Eukaryotic Viruses
Permutotetraviridae	Animals	Eukaryotic Viruses
Persimmon	Plants	Eukaryotic Viruses
Phaeocystis	Algae	Eukaryotic Viruses
Phenuiviridae	Animals	Eukaryotic Viruses
Phomopsis	Fungi	Eukaryotic Viruses
Phytophthora	Fungi	Eukaryotic Viruses
Picorna-like	Animals	Eukaryotic Viruses
Picornavirales	Animals	Eukaryotic Viruses
Pig	Environment	Eukaryotic Viruses
Pithovirus	Protozoa	Eukaryotic Viruses
Planaria	Animals	Eukaryotic Viruses
Point-Douro	Eukaryotes	Eukaryotic Viruses
Polemovirus	Plants	Eukaryotic Viruses
Polydnaviridae	Animals	Eukaryotic Viruses
Posavirus	Animals	Eukaryotic Viruses
PoSCV	Environment	Eukaryotic Viruses
Potyviridae	Plants	Eukaryotic Viruses
Quadriviridae	Fungi	Eukaryotic Viruses
Reoviridae	Animals	Eukaryotic Viruses
Rhabdoviridae	Animals	Eukaryotic Viruses
Rhizoctonia	Fungi&Plants	Eukaryotic Viruses
Rice	Plants	Eukaryotic Viruses
Riptortus	Animals	Eukaryotic Viruses
Roniviridae	Animals	Eukaryotic Viruses
Saccharomyces	Fungi	Eukaryotic Viruses
Salmovirus	Animals	Eukaryotic Viruses
San	Animals	Eukaryotic Viruses
Sanxia	Animals	Eukaryotic Viruses
Satellites	Protozoa	Eukaryotic Viruses
Sclerophthora	Fungi	Eukaryotic Viruses
Sclerotinia	Fungi&Plants	Eukaryotic Viruses
Sclerotium	Fungi	Eukaryotic Viruses
Sea	Animals	Eukaryotic Viruses
Sewage-associated	Environment	Eukaryotic Viruses
Shahe	Animals	Eukaryotic Viruses
Shayang	Animals	Eukaryotic Viruses
Sheep	Animals	Eukaryotic Viruses
Shuangao	Animals	Eukaryotic Viruses
Sida	Plants	Eukaryotic Viruses
Sinaivirus	Animals	Eukaryotic Viruses
Small	Plants	Eukaryotic Viruses
Sobemovirus	Plants	Eukaryotic Viruses
Solanum	Plants	Eukaryotic Viruses
Solenopsis	Animals	Eukaryotic Viruses
Spissistilus	Animals	Eukaryotic Viruses
Strawberry	Plants	Eukaryotic Viruses
Subterranean	Plants	Eukaryotic Viruses
Suffolk	Animals	Eukaryotic Viruses
Sunflower	Plants	Eukaryotic Viruses
Sunviridae	Animals	Eukaryotic Viruses
Swagivirus	Animals	Eukaryotic Viruses
Sweet	Plants	Eukaryotic Viruses
Synedrella	Plants	Eukaryotic Viruses
Tacheng	Animals	Eukaryotic Viruses
Tanay	Animals	Eukaryotic Viruses
Temperate	Plants	Eukaryotic Viruses
Thika	Animals	Eukaryotic Viruses
Tobacco	Plants	Eukaryotic Viruses
Togaviridae	Animals	Eukaryotic Viruses
Tolecusatellitidae	Plants	Eukaryotic Viruses
Tomato	Plants	Eukaryotic Viruses
Tongilchon	Animals	Eukaryotic Viruses
Torulaspora	Fungi	Eukaryotic Viruses
Tospoviridae	Animals	Eukaryotic Viruses
Totiviridae	Animals	Eukaryotic Viruses
Trichoderma	Fungi	Eukaryotic Viruses
Trichomonas	Protozoa	Eukaryotic Viruses
Trifolium-associated	Plants	Eukaryotic Viruses
Turkey	Environment	Eukaryotic Viruses
Turnip	Plants	Eukaryotic Viruses
Tymoviridae	Animals	Eukaryotic Viruses
ubei	Animals	Eukaryotic Viruses
unidentified	Human	Eukaryotic Viruses
Ustilaginoidea	Fungi	Eukaryotic Viruses
Velvet	Plants	Eukaryotic Viruses
Verbesina	Plants	Eukaryotic Viruses
Vernonia	Plants	Eukaryotic Viruses
Virtovirus	Plants	Eukaryotic Viruses
virus	Flaviviridae	Eukaryotic Viruses
Wabat	Animals	Eukaryotic Viruses
Wenling	Animals	Eukaryotic Viruses
Wenzhou	Animals	Eukaryotic Viruses
Wilkie	Eukaryotes	Eukaryotic Viruses
Wolkberg	Animals	Eukaryotic Viruses
Wuchan	Animals	Eukaryotic Viruses
Wuchang	Animals	Eukaryotic Viruses
Wuhan	Animals	Eukaryotic Viruses
Xingshan	Animals	Eukaryotic Viruses
Xinzhou	Animals	Eukaryotic Viruses
Yellowstone	Environment	Eukaryotic Viruses
Zhejiang	Animals	Eukaryotic Viruses
Chrysoviridae	Fungi	Fungal RNA Viruses
Baculoviridae	Animals	Invertebrate DNA Viruses
Ascoviridae	Invertebrate DNA Viruses	Invertebrate DNA Viruses
Asfarviridae	Invertebrate DNA Viruses	Invertebrate DNA Viruses
Metaviridae	Invertebrate DNA Viruses	Invertebrate RNA Viruses
Virgaviridae	Plants	Plant RNA Viruses
Betaflexiviridae	Plants	Plant RNA Viruses
Closteroviridae	Plants	Plant RNA Viruses
Secoviridae	Plants	Plant RNA Viruses
Tombusviridae	Plants	Plant RNA Viruses
Mimiviridae	Protozoa	Protozoa DNA Viruses
Cystoviridae	Bacteria	RNA Bacteriophages
Leviviridae	Bacteria	RNA Bacteriophages